linhas 10
colunas 20
...............+++++
..........++++++++++
..........A+++++++++
.............+++++++
..............++++++
....+a...........B++
...++++..........+++
....++............++
...................b
....................